000000200
570000860
100078940
006003050
000080000
200000007
435006008
001004000
062500190
