001003000
079050012
280090000
105008030
000007205
006000000
002300091
050800000
000640000
