270080600
030500100
008000030
000407010
900010706
600000400
700001840
800000000
090200050
