690000800
000200000
000008000
030600058
006501040
040000079
002005007
708030500
000000462
