902603080
000810900
000004010
080002000
009385120
203000050
400029005
008000030
000000400
